+------------------------------------------------------------------------------------------------------------------------------------------------------+
|S X  X  X           X  X       X          XX         XX X X  X        X       X            X     X  X   X              X    X                         |
|                 XX           XX                   X                         X    X                  X          XX    X  X   X         X            X |
|         XX                       X               X                       X            X      X                 X                    X         X      |
|     X    X X   X      X X      X       X               X XX   X     X         X            X                 X  XX  X    X  X                    X X |
|      X     X                   X X   X   X           X     XX               X       X                  X  X  X          X    X     X               X |
|         X   X              X       X       X      X            X                             XXX    X                         X          X           |
|       X     X X                               X                                                   X   X           XX                              X  |
|                          X    X    XX                               X  XX        X                                          X       X                |
|                       X   X              X   X     X                   XX                 X         X                               X      X    XX   |
|X     X     X  X     X        X     X  X           X                  X  X       X      X       X        X       X  X  X                              |
|         X                X     X X  X X                X                X         X   X X     X     X                                 X      X    XXX|
|  XX     X     XX      X          X  X         X                     X   X       XX   X X  X                   X  X               X          XX X     |
| XX    X                                                X         X                  X X               X X  X       XX         X          X   X X     |
|    X        X            X X      X   XX                  X                                    X         X        XX             XX    X             |
| X        X             X                        X          X                  X       X                                       X                      |
|         X        X X   X     X      X      X X      X       X                X                                   X  X     X   X                      |
|    X                              XX              X     X  X      X       X      X   X     X             X   X        X      X        X     X        |
| X    X    X   X      XX          X                  X    X   X X                 XX      X      X           X  X      X        X            X X    X |
|        X    X      X                   X X X      X     X    X      X   X    X  X                      X   X                    X  X XX X        X   |
|         X         X  X              X                    X                          X                 X   X X    X              X             X  X   |
|       X X                                X X                       X        X  X                               X X  X    X                          X|
|     X  X       X                     X X              X     X XX  X                X      X      X    X    X                     X  X           X   X|
| X       X   X X    X         X     X     X   X  X        X X                                                 X                    X           X      |
|      X                                                                          X        X            XX     X     X                           X    X|
|   X  X      X     XX               X           X                           X    X   X      X    X  X         X  X X        X   X          X          |
|X X            X       X           XX             X       X                    X     X  X     X         X                     X             X     X   |
| X                X X    X    X X     X        X         X X            X    XX                 X             X  X                                  X |
|                X X                  X                XXX                  X         X         X            X   XXX    X                          X X |
|             X                X                      X              X    X  X  X                X       X             X                      X   X  X |
|       X        X                   X  X                   X X          X          X   X     X     XX                X                       X   X  XX|
| X                X  X   X      X       X XX  X                    X                                    X  X          X  X          X           X     |
|                     X       X                  X      X         X                  X               X                       X        X      X         |
|    XX       XX                X XX   X          X                               X          X     X               X  X                         X X    |
|             X XX    X       X                 X            X         XX   X      X                X     X          X                                 |
|              X            X     X                    X                 X    X                                     X          XX         X X         X|
|    X         X                     X          X    X                                                            X XX       X    X                    |
|    X      X           X X  X         X          XX                    X                   X                 X       X      X               X        X|
|X            X             X   X                          XX        X       XXX            X X                           X     X XX X                 |
|                      X            X  X          X X          X           X  X                   XX               X         X X  X     X     X      X |
|  XX              X                 X      X  X    X   X    X            X                         X         X           X                  X         |
|  X   XX X        X   X                   X X                  X    X X       X                      X                    XX       X   X  X      X    |
|X X  X   X  X                     X      X                                                    X          X             X            X                 |
|                    X    X             X                       X          X    X    X             X   X X       X                                     |
|  X  X                    X                            X  X   X X        XX       X                                      X                 X       X  |
|X                X              X       X   X X       X     X    X       X      X       X   X                 X X                               X    X|
|   X                            X   X                                               X       X             X  X    X                         X         |
| X          X         X                     X     X     X   X   X     X                X                       X      X     X           XX            |
|                             X     XX X          X        X X       X        X    X                  X    X         X                    X X    X    X|
|                 X     X  X    X           X                   X   X X                X X  X       X              X          X                   X    |
|      X                 X            X            X                  X      X               X                        X XX      X         X  X  X X   X|
|   X  X                               X        XX   X                X    X                  X       X            XX       X                  X    X  |
|            XX X                      X    X                                   X X    X                                           XX X       X        |
|               X           XXX          X          X   X         X      X                          X           X       X                          X   |
|             X X                  XX           X       X XX    X    XX             X   X X      X                X                                    |
|                                           X                       XX                     X                 X  X     X        X X    X                |
|      X          X   X                                        X                  X   X    X   X               X                   X  X         X      |
|                                                     X  X    X  X  X                 X           X X       X    X    X         X                X     |
|               X                X                             X X          X     X              X  X                            X          X          |
|            X         XX  X                  X X     X               X              X    X X            X                  X     X  X                 |
|     X     X XX   X                X     X                       X          X        X          X  X                     X         X      X           |
|        X               X   X      X  X           X   X      X           X        X    X                              X        X                      |
|   X   X             X XX                            X                     X          X    X                   XX  X           X         X       XXX  |
|      X    X                X              X                    X     X               X   X                   X                                       |
|        X                X           X                                                                X            X   X   X         XX     X         |
|      X X  X          X      X               X                                X                                             X                         |
|          X   X                 X    X    X           X       X         X  X        X XXX         X         X X  X    X         X            X    X   |
|  X                            XX                              X    X XX  X             X                       X                           X         |
|                                        X    X                  X X           X     X           X         X                     XX     X         X  X |
|XX                                X  X   XX                  X X  X             X                X                                             X   XX |
|                      X    XX   XX     X      X         X        XX     X       X      X                                X                             |
|                           XX             X                  X             X X              XXX               X           XXX          X X            |
|X  X          XXX            XX        X       X                      X              XX    XX  X X       X      XX     X   X X       X                |
|                               X                   X               X                  X              X    XX         X         X  X          X       X|
|    X             X                 X      X       XX             XX X                         X         X   X X                   X                  |
|               X                                                   X   X      X            X               X    X              X            X      X  |
|X          XX               X X    X                  X  X X             X                        X X                 X              X             X  |
|            X XX        X               X          XX           X                      X  X           X    X                  X             X     X XX|
|       X  X       X      X   X        X     X         X        X   X       X          X             X       XX      X           X           X       X |
|        X X                X         X    X               X     X       X                          X          X    X X  X              X   X X        |
|                             X             X    XX                X       X        X                                 X                  X X   X      X|
|     X                                                 X       X          X      XX X          X               X   X                      X           |
|     X         X X           X     XX                        X      XX         X           XX        X   X   X     X X   X       X       X          X |
|                  X           X    X           X                         X           X      X          X    X   X   X                               X |
|      X   X                     X             X  X      XXX                      X  X  X      X                      XX  X              X          X X|
|         XX                 X      X X     X   X  X X      X    XX   X        X  XX      X           X                X                   X X   X    X|
|    X           X    XX  X   XX         X         X         X X        X                          X                  X    X   X          X   X      X |
|      X                         X              X   X   X      X X    X      XXX    XXX     XX         X         X         XX X       X                |
| XX   XX              X  X  X                    X        X    XX    X XX    X   X      X                                  X X              X  X      |
|   X                  X X X                X    X                                                                                X                    |
|        XX                         X         X     XXX         X     XX                X X                     X X       X         X                  |
|                  X  X        X                          X     X      X    X   X X    X           X               X           X      X    X           |
|                                      X   X         X       X               X X     X X     X         X    X       X   X    X              X          |
|             X          X      X   X             X          X                      X   X X           X                  XX       X   X X    X         |
|     X     X                          X          X                                 X                           X                                      |
|     X    X                 X  X              X               X               X                        X       X   X X                      X      X  |
|    X     X                   X X                 X           X X            X      X         XX    X       X      X          X         X             |
|  X          X            X         X               X       X          X         X   X         XX           X              X                          |
|         XX                 X                 X   X         X      X                  X   X                                     X            X   X X  |
|       X                XX      X X               X   XX         X                 X                                              X                   |
|      XX                         X            X      X     X               X  X       X      X           X           X          X        X            |
|        XX   X    X             X   X   X                         X   X      X                          X      X       X  X                     X   X |
| X  X      XX           X                X              X      XX            X  X X   X    X   X  X     X    X               X        X               |
|   X              X           X                                      X                   X        X      XX                    X       X          X   |
|            X  X     X       X     X    X      X      X   X               X  X     X  X     X       X  X         X             X              X     X |
|  X             X    X      X  X   X             XX X      X                              X                             X          X          X X     |
|            X                    X  X X                 X            X                         X   X                  X                            X  |
|                                 X     XX      X   X                      X    X                           XX           XX  X   X       X         X   |
|                                                                                       X    X   X                       X    X X               X      |
| X                    X                                     X  X              X        X      XXX X       X                                   XXXX    |
|                      X                       X   X                   X           X                         XX             X               X          |
|       X        X       X        X X    X             X              XX    XX                XXXX       XX     XX   X                  X           X  |
|X       X    X        X    X   X    X              X       X             X        X        X  XX X                          X           X             |
|                     X                    X X          X   X  X  X                X     XX  X               X  X   X                           X      |
|  X   X        X    XXX  X             X  XX   X                         X                                  X  X           X      X                  X|
|         X X   X      X                              X         X    X                          X                             XX   X        X    X   X |
|                XX   X   X                X       X  X    X              X       X X    X  X  X    X                            X                  X  |
|     X   X                            XX  X        X                                        X    X  X X      XX  X   X     X      X           X     X |
|           X X    X   X                          X                 X            X    XX                  XX                           X          X  X |
|  X          X                      X                    X        XX    X          X     XX   XX             X           XXXX   X                X    |
|              X                        X X                      X          XX             X  X    X           X                   X            X  X   |
|                   XX     X X  X                    X             X     X       X             X     X        X                           X            |
|   X                   XX         X    X          X      X             X      X X          X                                X X                 X     |
|                           X            X                 XX      X  X           X                 X      XX     X   X                 X        X    X|
|                    X X     XX      X  X        XX   X           X            X X                      X         X                     X              |
|               X              X           X  XX         X               X    X  X   X        X          X  X X    X     X X                   X       |
|                XX       X         X     XX  X X  X X                   X  XX   X            X   X                                                X   |
|           X                           XX                     X                 X          XX                          X   X                          |
| X                          X   X X                           X                      X                    XXX   X        X X  X             X     X   |
|      X  X    XXX X  X    X     X X                              X        X           X    XXX     X  XX         XX                     X      X  X   |
|     X       X                        X                 X   X X            X       X     X     X        X                 X      XX                   |
|                      X                     X                                                  X  X         X     X    X   XX    X             X X    |
|X          X   X  X    XX       X      X              X      X  X          X X                   X                             X           X  X     X |
|         X                      X       X         X           X   X   X         X    X        X             X                     X X                 |
|   X  X      X      XX           XX                         X                          X      X   X             XXX               X              X    |
| X        X        X       X                     X            X                       X         X   X             X   X         X   X    XX X  X   X  |
|      X               X XX    X     X       X                                       X   X  X             X          X             X         X       X |
|                                                      X   X     X         X                   X                         X  X       XX      X      X   |
|         X                     X          X            X    X X                 X         X X          X X  XX  X                          X          |
|     X                                                   X         X           XX        X    X     X       X              X                          |
|                     XX              X                        X     X   X            X     X                    X   X X           X  XX      X        |
|            X    X  X  X  X                    X  X                X   X       X     X                 X      X      X                         X      |
|                X              X                               X                X                                      X     X             X          |
|   X        X            XX    X       X X                         X   X    X    X       X   X    X             XX    X                          X    |
|                 XX        X             X  X  X              X        X          X   X  X                                                         X  |
|  X         X   X      X            X X     X                             X           X            X            X    X            X            X      |
|X      XX    XX           X          X                  X                          X   X       X                      X X  X               X   X      |
| X          X                           X X X  X                                       X  X    X X    X  X       X           X  X  X         X   X    |
|      XX                                     X           X                                   X                     X                   X        X     |
|   X              X                  XX    XX            X          X    X                   X     XX          XX                        X     X      |
|               X            X             X        X X     X              X                             X       X   X   XX                           G|
+------------------------------------------------------------------------------------------------------------------------------------------------------+